SO ./textures/BookCaseLibrary.xpm
WE ./textures/PaintingLibraryWall.xpm
EA ./textures/SimpleLibraryWall.xpm
NO ./textures/WindowLibrary.xpm

C 12,12,12
F 25,25,25

111111111111111111111
111111111100000100011
101010001011111110001
100010100010000010001
101110101111101011101
100000101000101000001
101111101011101111111
101000001000000000001
1011001110010111110101
101010001010100010001
101111101010101010101
100000101010001010001
1011111010111110111011
10100010100010001000101
1011111011101011101111
101000100000100010101
10010111011111111101
1N0010001000000000001
101111111111111111111
11111111111111111111111